"filename", "language", "C++", "C", "comment", "blank", "total"
"d:\study\c\c-lexue\数据结构\calculateWPL.cpp", "C++", 55, 0, 5, 11, 71
"d:\study\c\c-lexue\数据结构\one.cpp", "C++", 104, 0, 6, 4, 114
"d:\study\c\c-lexue\数据结构\set-union.cpp", "C++", 108, 0, 8, 18, 134
"d:\study\c\c-lexue\数据结构\string_zip.c", "C", 0, 120, 3, 24, 147
"d:\study\c\c-lexue\数据结构\一元多项式.cpp", "C++", 103, 0, 14, 10, 127
"d:\study\c\c-lexue\数据结构\中缀转后缀.cpp", "C++", 92, 0, 6, 3, 101
"d:\study\c\c-lexue\数据结构\二叉树的建立与基本操作.cpp", "C++", 155, 0, 4, 13, 172
"d:\study\c\c-lexue\数据结构\前缀码判断.cpp", "C++", 53, 0, 0, 4, 57
"d:\study\c\c-lexue\数据结构\博弈树.cpp", "C++", 0, 0, 0, 1, 1
"d:\study\c\c-lexue\数据结构\广义表反序.cpp", "C++", 202, 0, 8, 17, 227
"d:\study\c\c-lexue\数据结构\广义表建立树.cpp", "C++", 73, 0, 3, 5, 81
"d:\study\c\c-lexue\数据结构\广义表的使用.cpp", "C++", 107, 0, 3, 7, 117
"d:\study\c\c-lexue\数据结构\循环小数.c", "C", 0, 95, 3, 13, 111
"d:\study\c\c-lexue\数据结构\循环节.c", "C", 0, 67, 1, 12, 80
"d:\study\c\c-lexue\数据结构\最近祖先.cpp", "C++", 26, 0, 0, 2, 28
"d:\study\c\c-lexue\数据结构\树的同构.cpp", "C++", 97, 0, 1, 9, 107
"d:\study\c\c-lexue\数据结构\矩阵快速乘法.c", "C", 0, 96, 2, 16, 114
"d:\study\c\c-lexue\数据结构\矩阵快速转置.cpp", "C++", 55, 0, 1, 10, 66
"d:\study\c\c-lexue\数据结构\股票撮合系统.cpp", "C++", 72, 0, 1, 10, 83
"d:\study\c\c-lexue\数据结构\表达式求值.cpp", "C++", 153, 0, 6, 8, 167
"d:\study\c\c-lexue\数据结构\表达式求值2.cpp", "C++", 205, 0, 9, 16, 230
"d:\study\c\c-lexue\数据结构\还原二叉树.cpp", "C++", 65, 0, 1, 4, 70
"d:\study\c\c-lexue\数据结构\迷宫.c", "C", 0, 89, 4, 3, 96
"d:\study\c\c-lexue\数据结构\退栈检测.cpp", "C++", 40, 0, 0, 3, 43
"d:\study\c\c-lexue\数据结构\链表原地逆序.cpp", "C++", 67, 0, 1, 8, 76
"Total", "-", 1832, 467, 90, 231, 2620